XOXXXXXXXXXXXXXXXXXXX
X XXXXXXXXXXXXXXXXXXX
X                 XXX
XXXXXXXXXXXXXXXXX XXX
XXXXXXXXXXXXXXXXX XXX
XX            XXX XXX
XX XXXXXXXXXX XXX XXX
XX XXXXXXXXXX     XXX
XX XXXXXXXXXXXXXXXXXX
XXOXXXXXXXXXXXXXXXXXX  
