X O XXXXXXXXXXXXXXXXX
x   xxxxxxxxxxxxxxxxx
x                  xx
xxxxxxxxxxxxxxxx   xx
XXXXXXXXXXXXXXXX   XX
X             XX   XX
X   XXXXXX    XX   XX
X   XXXXXX         XX
X   XXXXXXXXXXXXXXXXX
X O XXXXXXXXXXXXXXXXX  
X O XXXXXXXXXXXXXXXXX  
