XXXXXXXXXXXXXXXXXXXX
XO                 X
X                  X
X                  X
X                  X
X                  X
X                  X
X                  X
X                 OX
XXXXXXXXXXXXXXXXXXXX
